                ######################                             ###############
                #....................#             ###########     #.............#
                #....................#             #.........#     #.............#
                #....................#             #.........#     #.............#
                #....................#             #.........#     #.............#
                #....................###############.........#     #.............#
                #............................................#     #.............#
                #............................................#######.............#
                #....................###############.............................#
                #....................#             #.............................#
                #....................#             #.........#######.............#
                #....................#             #.........#     #.............#
                #....................#             ####...####     ###############
                ########..############                #...#
                       #..#                           #...#
                       #..#                           #...#
############           #..#                           #...#
#..........#           #..#                           #...#
#..........#           #..#                           #...#
#..@.......#           #..#                           #...#
#..........#############..#                           #...#
#.........................#                           #...#
#.........................#                           #...#
#..........#########..#####                   #########...#########
#..........#       #..#                       #...................#
#..........#       #..#                       #...................#
#..........#       #..#                       #...................#
############       #..#                       #...................#
                   #..#                       #...................#
                   #..#                       #...................#
                ####..########                #...................#
                #............#                #...................#
                #............#                #...................#
                #............#                #...................#
                #............#                #...................#
                #............#                #...................#
                #............#                #...................#
                #............#                #...................#
                #............#                #####################
                ##############