           ########     ########     ########
######     #1..1.1#     #2....2#     #..3...#
#....#######*....1#######\2....#######^...3.#
#@........._.*...1_....._.\...2_....._.^....e
#.........._.*..1._....._.\..2._....._.^..3.e
#....#######*.....#######\..2..#######^.....#
######     #111...#     #..2..2#     #..3..3#
           ########     ########     ########