           ########
######     #1..1.1#
#....#######*....1#
#@........._.*...1#
#.........._.*..1.#
#....#######*.....#
######     #111...#
           ###__###
             #..#
             #..#
             #..#
           ###__###     ########
           #.\..\.#     #..3...#
           #..\\..#######^...3.#
           #.....2_....._.^....e
           #2.2.2._....._.^..3.e
           #.2.2..#######^.....#
           #..2..2#     #..3..3#
           ########     ########