           ########
######     #1..1.1#
#....#######*....1#
#@........._.*...1#
#.........._.*..1.#
#....#######*.....#
######     #111...#
           ###__###
             #..#
             #..#
             #..#
########   ###__###
#..3...#   #.\..\.#
#^...3.#####..\\..#
e.^...._..._.....2#
e.^..3._..._2.2.2.#
#^.....#####.2.2..#
#..3..3#   #..2..2#
########   ########