########    ########
#..3...#    #.22..2#
#.3...^######..2..2#
e....^._...._2..2..#
e.3..^._...._......#
#.....^######..\\..#
#..3...#    #.\..\.#
########    ###__###
              #..#
              #..#
              #..#
            ###__###
            #11....#   ######
            #..1..*#####....#
            #....*._.......@#
            #1...*._........#
            #..1..*#####....#
            #111...#   ######
            ########