########
#......#
#......#
#...@..#
#......#
#......#
#......#
########